#################################################################################
#...#..j..........#.........#...........#.......#........n......#.....#........m#
#.#.#.#.###########.###.#####.#######O#####.###.#.#########.#.###.#.###.###.###.#
#.#.#.#...............#.Z.......#...#...#...#.#.#.#.......#.#.....#.....#.X.#...#
#.#.#.###########################P#.#.#.#.###.#.###.#####.###.###########.###.###
#.#.#.#.......#.........#......b..#.#.#.#.#.......#...#.#...#.....#.......#.....#
#.#.#.#.###.###.#######.#.#########.###.#.#######.###.#.###.#####.#.#############
#.#.#.#.#...#...#..l#...#.#.......#.#...#.....#.......#.#...#.....#.........#..k#
#.###.#.###.#.#####.#.###.#######.#.#.###.###.#########.#.###.#####.#######.#.#.#
#...#.#...#.#.#...#...#...#.....#.#...#.#...#...#.....#.#.#...#...#...#...#...#.#
#.#.#.#.#.###.#.#U###.###.#.###.#.#####.###.###.#.###.#.#.#.###.#.#####.#.#####F#
#.#.#.#.#...#...#...#.....#.#...#.......#...#g#...#.#.#...#.#...#...#.E.#.....#.#
#.#.#.#.###.#######.#######.###.###Y#.###.###.#####.#.###.###.#####.#.#######.#.#
#.#...#...#...#.....#......a..#...#.#...#.....#.....#...#.....#.......#.....#...#
#.#####D#####.#.#######.#####.###.###.#.#####.#.###.###.#################.#####.#
#.M...#.#...#.#.#c....#...#...#.#...#.#.#...#.#.#.#.#.#.#...............#...#...#
#####.###.#.#.#H#.###.#####.###.###.#.#.#.###.#.#.#.#.#.#.###########.#.###.#.###
#...#.....#.#.#.#...#...#...#.....#.#.#.#...#.#.#.....#.......#.....#.#.#...#.#.#
#.#.#######.#.#.#.#####.#.###.#.###.###.#.#.#.#.#####.#########.###.###.#.###.#.#
#.#.#....x#.#.#...#.....#.#...#.#..i#...#.#.#.#...#...#.........#.....#.#...#...#
#.###K#.#.#.#.#####.#####.#.###.#.###.#####.#.###.#####.###.#########.#.#.#.###.#
#...#.#.#.#.#.....#..r#...#...#.#.#.....#...#.....#.....#...#.......#...#.#.....#
#.#.#.#.###.#.###.#####.#####.#.#.#.###.#.#####.###.#####.#########.#####.#####.#
#.#.#.#.....#.#.........#.....#.#.#...#.#.......#...#...#.#.........#.....#...#.#
###.#.#########.#########.#####.#.#####.#####.###.#.#.#.###.#########.#####.#.#.#
#...#...#.....#.#...........#...#.....#.#..t#.#.#.#.#.#.....#...#.........#.#.#.#
#.#####.#.#.#.#.#####.#####.#########.#.#.#.#.#.#.#.#.#######.###.#########.#.###
#.......#.#.#.#.....#...#.#.....#...#.#.#.#.#...#.#.#.....#.......#...#...#.#...#
#.#########.#.###.#.###.#.#####.#.#.#.#.#.#.#####.#.#####.#########.#.#.#.#.###.#
#.#.....#...#...#.#.#...#...#...#.#...#.#.#.......#.#...#.......#q..#...#...#...#
#.###.#.#.#####.###.###.#.###.###.#####.#.#########.###.#######.#.###########.###
#.....#.#...#.#...#...#.#...#...#...#...#...#...#.#.....#.......#.#...#.....#...#
#######.#.#.#.###.#.#.#.###.###.###.###.#.#.#.#.#.#####.#.#######.#.###.#.#####.#
#.....#.#.#.#.....#.#.#.......#...#.....#.#.#.#.#.#.....#.#...#...#...#.#.....#.#
#.#.###.#.#.###.#####.#####.###.#.#####.#.#.#.#.#.#.#####.#.#.#.#####.#.#####.#.#
#.#.#...#.#...#.#...#.#.....#...#...#...#.#...#.#...#...#...#...#.....#.#.....#.#
###.#.###.###.#.#.#.#.#######.#######.###.#####.#.###.#.#########.#.###.#.###.#.#
#...#.#...#...#.#.#.#...#.....#.....#.#.#.#...#.#.#...#.......#...#.....#...#.#.#
#.###.#####.###.#.#.###.#.#####.###.#.#.#.###.#.###.#######.###.###########.###.#
#...........#.....#.....#.........#...........#...........#...............#w....#
#######################################.@.#######################################
#.....#.....#.......#.........#...................#.#...................#...#...#
#.###.###.#.#.#####.#.#.#####.#.#####.#.#.#######.#.#.###############.#.#.#.#.#.#
#...#.....#...#.#...#.#...#.#.#.#.#...#.#.......#...#...#...#...#...#.#...#...#.#
###.#####.#####.#.#######.#.#.#.#.#.###.#.#####.###.###.#.###.#.#.#.#.#########.#
#...#...#.#...#.#.....#...#...#...#...#.#.#...#...#.#...#.#...#...#.#.........#.#
#.###.#.###.#.#.#####.#.###.#########.#.#.###.###.###.###.#.#######.###########.#
#.....#.....#.#.....#...#.#.#.......#.#.#.......#.....#...#.#...................#
#############.#####.#####.#.#.#####.#.#.#######.#######.#.#.###.###############.#
#...........#.....#.......#.#...#.#.#.#.#.....#.........#.#...#.#.........#...#.#
#########.#.#####.#.###.###.###.#.#.#.###.#.#.#######T#######.###.#######.#.###.#
#........f#.#...#.#...#.....#...#...#...#.#.#.#.....#.#.......#...#...#...#.#...#
#.#######.###.#.#.#####.#####.###.#####.#.#.#.#.###.#.#.#######.#####.#.###.#.###
#.#.#.....#...#.#.....#.......#...#.....#.#.#.#.#.#...#.#...#.......#.#.#.......#
#.#.#.#####.###.#.###.#########.###.#.###.#.###.#.#####.#.#.#.#####.#.#.#######.#
#.#.#...#...#.#.#...#.#...#...#.#.#.#...#.#...#.#...#...#.#...#...#...#.#.....#.#
#.#.###.#.###.#.###.#.###.#.#.#.#.#.###.#####.#.#.#.#.###.#####.#.#####.#.###.#.#
#.#.....#.#...#...#.#...#...#.#.#...#.#.#.....#.#.#.#.......#...#.#...#....s#.#v#
#.#.#####.#.#.###.###.#.#.###.#.###.#.#.#.#####.###.#####.###.###.#.#.#######.#.#
#.#...#...#.#...#...#.#.#...#.#...#..y#.#.#.........#...#.#...#.....#.........#.#
#.###.#.#######.###.###.#####.###.#####.#.#.#####.###.#.###.#########.###########
#.#...#.........#.#...#.....#...#.#.....#...#...#.#...#...#.#.......#.#.........#
#.#.###########.#.#########.#.###.#.#########.#.#.#.#####.#.#######R###.#######.#
#.#.#.....Q...#...#.........#...#.#.#...#...#.#.#.#.#...#.....#...#.....#...#.C.#
#.###.#.#########.#.###.#######.#.#.#.#.#.#.#.#.#.#.###.#####.#.#.#########.#.###
#...#.#...#...G.#.#...#.#.#.....#.#...#.#.#.#.#.#.#...#...#...#.#.....#.....#.#.#
#.#.#.###.#.###.#.#####.#.#.#.###.#####.#.#.#.#.#.###.#.#.#.#####.###.#.#####.#.#
#.#.#...#.#.#...#.#.....#.#.#.#...#...I.#.#...#.#...#.#.#.#.#.....#.#...#...#...#
#.#S###.#.#.#.#.#.#.#####.#.#.#.###.###.#.#####.#####.#.#.#.###.###.###.#.#.###.#
#.#.....#...#.#.#...#.......#...#...#.#.#.....#.......#.#.#...#.#.#...#.#.#.....#
#.###########.#######.###########.###.#.#.###.#########.#.###.#.#.#.#.#.#.#######
#e#.......#...#.....#.#.......#...#.#...#.#...#...#.#...#.......#...#...#.#.....#
#.#.#######.#.#.#.###.#.###.###.#.#.#.###N#.###.#.#.#.#########.#####.###.#.###.#
#.#.#.......#.#.#.....#...#.#...#.#.....#.#.#...#.#.#.#..p..#...#...#...#h..#.#.#
#.#.#.#########W#########.#.#.###.#####.###.#.###.#.#.#.###.#####.#B#########.#.#
#...#d....#...#.....#...#.#.....#.....#.#...#.#.#.#.#.#...#.#.....#.#.......#...#
###.#####.#.#.#####.#.#.###.#######.#.#.#.###.#.#.#.#.###.#.#.#####.#.#####.#.###
#...#...#...#.....#...#.V.#.#.....#.#.#.#.#...#z#.#...#...#.#...#.#...#.#.L.#.#.#
#.#####.#######.#########.###.###.###.#.#.#.###J#.#####.###.###.#.#####.#.###.#.#
#.............#...............#.....A.#.#.......#........o#.............#....u..#
#################################################################################